- Acto de lanzar: Ver movimiento de lanzamiento.
- Afectar la jugada: Una infracción o señalamiento afecta la jugada si es razonable suponer que el resultado de la jugada específica podría haber sido significativamente diferente si la infracción o el señalamiento no hubiera ocurrido.
- Zona de anotación de ataque: La zona de anotación en la que el equipo en cuestión está intentando anotar actualmente.
- Mejor perspectiva: El punto de vista más completo disponible para un jugador que incluye la posición relativa del disco, el suelo, los jugadores y los marcadores de línea involucrados en la jugada.
- Señalamiento (Call): Una declaración claramente comunicada de que ha ocurrido una falta, infracción, violación, pérdida de posesión o lesión. Se pueden utilizar los siguientes términos: Foul (Falta), Travel (Viaje), nombre específico de la Infracción de Marcaje, Violation (Violación) (o nombre específico de la Violación), nombre específico de las pérdidas de posesión, Technical (Técnica) e Injury (Lesión).
- Atrapada: Un disco que no gira atrapado entre al menos dos partes del cuerpo. Si un jugador atrapa inicialmente un pase y luego, antes de establecer la posesión, no mantiene la atrapada (“mantener la atrapada” significa continuar teniendo un disco que no gira atrapado entre al menos dos partes del cuerpo), esa atrapada inicial se considera terminada.
- Zona central: El área del campo de juego que incluye las líneas de gol, pero excluye las zonas de anotación y las líneas perimetrales.
- Zona de anotación de defensa: La zona de anotación en la que el equipo en cuestión está intentando evitar que el oponente anote.
- Jugador defensivo: Cualquier jugador cuyo equipo no está en posesión del disco.
- Zona de anotación: Una de las dos áreas al final del campo de juego donde los equipos pueden anotar un gol atrapando el disco allí.
- Línea de gol: La línea que separa la zona central de cada zona de anotación. No forma parte de la zona de anotación.
- Suelo: El suelo consiste en todos los objetos sólidos sustanciales, incluyendo césped, conos marcadores, equipamiento, agua, árboles, cercas, paredes y no jugadores, pero excluye a todos los jugadores y su ropa usada, partículas en el aire y precipitaciones.
- Contacto con el suelo: Se refiere a todo contacto del jugador con el suelo directamente relacionado con un evento o maniobra específica, incluyendo aterrizaje o recuperación después de estar en desequilibrio (por ejemplo, saltar, lanzarse, inclinarse o caer).
- Marcando: Un defensor está marcando a un jugador ofensivo cuando está a menos de tres metros de ese jugador ofensivo y está principalmente enfocado y reaccionando a ese jugador ofensivo.
- Intercepción: Cuando un jugador del equipo defensivo establece la posesión de un lanzamiento de un jugador del equipo ofensivo.
- Posición legítima: La posición estacionaria o en movimiento establecida por un jugador que no infringe ninguna regla.
- Línea: Un límite que define las áreas de juego. En un campo sin líneas, el límite se define como una línea imaginaria entre dos marcadores de campo con el grosor de dichos marcadores. Los segmentos de línea no se extienden más allá de los marcadores definitorios.
- Hacer una jugada con el disco: Cuando el disco está en el aire y un jugador está intentando hacer contacto con el disco de cualquier forma, por ejemplo, atraparlo o bloquearlo. Esto incluye el proceso de correr hacia el lugar donde esperan hacer contacto con el disco.
- Marcador: El jugador defensivo que puede llamar el conteo de "stall" al lanzador.
- Contacto menor: Contacto que implica una fuerza física mínima y no altera los movimientos o la posición de otro jugador. El contacto con los brazos o manos extendidas de un oponente que están a punto de, o ya están, contactando el disco, o el contacto con la mano del lanzador durante el movimiento de lanzamiento, no se considera contacto menor.
- No jugador: Cualquier persona, incluyendo un miembro del equipo, que no es actualmente un jugador.
- Jugador ofensivo: Un jugador cuyo equipo está en posesión del disco.
- Fuera de límites (OB): Todo lo que no forma parte del campo de juego, incluyendo las líneas perimetrales.
- Líneas perimetrales: Líneas que separan la zona central o la zona de anotación del área fuera de límites. No forman parte del campo de juego.
- Pivote: Cuando el lanzador se mueve en cualquier dirección manteniendo una parte de su cuerpo en contacto constante con un punto específico en el suelo llamado punto de pivote. Un lanzador establece un punto de pivote colocando, o manteniendo, una parte particular de su cuerpo en un punto específico, que pretende utilizar como su punto de pivote. Si un lanzador tiene múltiples opciones para un punto de pivote, el punto de pivote no se determina hasta que pivotea.
- Ubicación del pivote: El punto en el campo de juego donde se requiere que el lanzador establezca un punto de pivote después de una pérdida de posesión, después del "pull", después de un tiempo muerto, después de salir de la zona central, o donde ya se ha establecido un punto de pivote.
- Jugada: El tiempo después de que ha comenzado el "pull" y antes de que se marque un gol. La jugada puede detenerse debido a un señalamiento, en cuyo caso la jugada se reinicia con una verificación.
- Jugador: Las personas que están participando activamente en el punto de juego actual.
- Campo de juego: El área que incluye la zona central y las zonas de anotación, pero excluye las líneas perimetrales.
- Posesión del disco: Un jugador establece la posesión de un pase cuando: 1) atrapa un pase y mantiene esa atrapada por más de un instante notable, y 2) mantiene la atrapada durante todo el contacto con el suelo relacionado con la atrapada, o hasta que lanza el disco. Un jugador también puede establecer la posesión cuando un disco que ya ha tocado el suelo es recogido, o se le da, después de una pérdida de posesión, "pull" o detención. Una vez que un jugador ha establecido la posesión, puede cambiar su agarre en el disco y eso no afecta su posesión, siempre que mantenga el contacto con el disco. Un disco en posesión de un jugador, o atrapado por un jugador, se considera parte de ese jugador. El equipo cuyo jugador está en posesión o cuyos jugadores pueden recoger el disco se considera el equipo en posesión.
- Pre-stall: Una advertencia sobre los límites de tiempo para reanudar el juego, emitida dando advertencias a los veinte (20), diez (10) y cinco (5) segundos (según corresponda).
- Pull: El lanzamiento de la defensa a la ofensiva que inicia el juego al comienzo de una mitad o después de un gol. El "pull" no se considera un pase legal. Receptores: Todos los jugadores ofensivos que no sean el lanzador.
- Detención de Espíritu: Una detención para discutir asuntos relacionados con el Espíritu de Juego.
- Detención del juego: Cualquier detención del juego debido a una falta, violación, discusión, señalamiento impugnado, lesión o tiempo muerto, que requiere una verificación para reiniciar el juego.
- Lanzamiento: Un disco en vuelo después de cualquier movimiento de lanzamiento, incluyendo después de un intento falso y un disco dejado caer intencionalmente, que resulta en la pérdida de contacto entre el lanzador y el disco. Un pase es equivalente a un lanzamiento.
- Lanzador: El jugador ofensivo en posesión del disco, o el jugador que acaba de lanzar el disco antes de que se haya determinado el resultado del lanzamiento.
- Movimiento de lanzamiento: El movimiento que transfiere el impulso del lanzador al disco en la dirección de vuelo y resulta en un lanzamiento. Los pivotes y las preparaciones no forman parte del acto de lanzar.
- Pérdida de posesión: Cualquier evento que resulta en un cambio del equipo en posesión. Una pérdida de posesión no se considera una violación.
- Donde el disco se detiene: Se refiere a la ubicación donde un jugador establece la posesión, el disco se detiene naturalmente, o donde el disco se impide rodar o deslizarse.